FRANCE ESPAGNE PORTUGAL ANDORRE ITALIE AUTRICHE SUISSE ALLEMAGNE LUXEMBOURG BELGIQUE PAYS-BAS 
11
0 1 0 1 1 0 1 1 1 1 0
1 0 1 1 0 0 0 0 0 0 0
0 1 0 0 0 0 0 0 0 0 0
1 1 0 0 0 0 0 0 0 0 0
1 0 0 0 0 1 1 0 0 0 0
0 0 0 0 1 0 1 1 0 0 0
1 0 0 0 1 1 0 1 0 0 0
1 0 0 0 0 1 1 0 1 1 1
1 0 0 0 0 0 0 1 0 1 0
1 0 0 0 0 0 0 1 1 0 1
0 0 0 0 0 0 0 1 0 1 0
